51
16
0 0 0 0 0 0 86 87 87 87 87 87 88 0 0 0 0 0 0 0 0 0 0 0 0 0 0 0 0 0 0 0 0 0 0 0 0 0 0 0 0 0 0 0 0 0 0 0 0 0 0 
0 0 0 0 0 0 86 87 87 87 87 87 88 0 0 0 0 0 0 0 0 0 0 0 0 0 0 0 0 0 0 0 0 0 0 0 0 0 0 0 0 0 0 0 0 0 0 0 0 0 0 
0 0 0 0 0 0 86 87 87 87 87 87 88 53 53 53 53 53 53 53 53 53 53 53 53 53 53 2 3 4 53 53 53 53 53 53 53 53 53 53 53 0 0 0 0 0 0 0 0 0 0 
0 0 0 0 0 0 86 87 87 87 87 87 88 0 0 0 0 0 0 0 0 0 0 0 0 0 0 6 7 8 0 0 0 0 0 0 0 0 0 0 0 0 0 0 0 0 0 0 0 0 0 
0 0 0 0 0 0 86 87 87 87 87 87 88 0 0 0 0 0 0 0 0 0 0 0 0 0 0 9 10 11 0 0 0 0 0 0 0 0 0 0 0 0 0 0 0 0 0 0 0 0 0 
0 0 0 0 0 0 89 90 90 90 90 90 91 0 0 0 0 0 0 0 0 0 0 0 0 0 0 0 12 0 0 0 0 0 0 0 0 0 0 0 0 0 0 0 0 0 0 0 0 0 0 
0 0 0 0 0 0 0 0 0 0 0 0 0 0 0 0 0 0 0 0 0 0 0 0 0 0 0 0 13 0 0 0 0 0 0 0 0 0 0 0 0 0 0 0 0 0 0 0 0 0 0 
0 0 0 0 0 0 0 0 0 0 0 0 0 0 0 0 0 0 0 0 0 0 0 0 0 0 0 0 14 0 0 0 0 0 0 0 0 0 0 0 0 0 0 0 0 0 0 0 0 0 0 
0 0 0 0 0 0 0 0 0 0 0 0 0 0 0 0 0 0 0 0 0 0 0 0 0 0 0 15 16 17 0 0 0 0 0 0 0 0 0 0 0 0 0 0 0 0 0 0 0 0 0 
0 0 0 0 0 0 0 0 0 0 0 0 0 0 0 0 0 0 0 0 0 0 0 0 0 58 63 59 59 59 59 59 59 59 60 0 0 0 0 0 0 0 0 0 0 0 0 0 0 0 0 
0 0 0 0 55 56 57 0 0 0 0 0 0 0 0 0 0 0 0 0 0 0 0 0 0 71 66 66 66 66 66 66 66 66 67 0 0 0 0 0 0 0 0 0 0 0 0 0 0 0 0 
83 84 84 84 84 84 84 84 84 84 84 84 84 85 0 0 0 0 0 0 0 0 0 0 0 65 66 66 66 66 66 66 66 66 67 63 63 63 63 63 0 0 0 0 0 0 0 0 0 0 0 
86 87 87 87 87 87 87 87 87 87 87 87 87 88 0 0 0 0 0 0 0 0 0 0 0 65 66 66 66 66 66 66 66 66 67 66 66 66 66 66 0 0 0 0 0 0 0 0 0 0 0 
86 87 87 87 87 87 87 87 87 87 87 87 87 88 0 0 0 52 53 53 53 53 53 54 0 65 66 66 66 66 66 66 66 66 67 66 66 66 66 66 0 0 0 0 0 0 0 0 0 0 0 
86 87 87 87 87 87 87 87 87 87 87 87 87 88 0 0 0 0 0 0 0 0 0 0 0 65 66 66 66 66 66 66 66 66 67 66 66 66 66 66 0 0 0 0 0 0 0 0 0 0 0 
86 87 87 87 87 87 87 87 87 87 87 87 87 88 0 0 0 0 0 0 0 0 0 0 0 65 19 19 19 19 19 19 19 66 67 66 66 66 66 66 0 0 0 0 0 0 0 0 0 0 0 
