39
15
37 0 37 0 0 0 0 0 0 0 0 0 0 0 0 0 0 0 0 0 0 0 0 0 0 0 0 0 0 0 0 0 0 0 0 0 0 0 0 
37 0 37 0 38 0 0 0 0 0 0 0 0 0 0 0 0 0 0 0 0 0 0 0 0 0 0 0 0 0 0 0 0 0 0 0 0 0 0 
36 0 36 0 36 0 0 0 0 0 0 0 0 0 0 0 0 0 0 0 0 0 0 0 0 0 0 0 0 0 0 0 0 0 0 0 0 0 0 
30 32 32 31 32 32 0 0 0 0 0 0 0 0 0 0 0 0 0 0 0 0 0 0 0 0 0 0 0 0 0 0 0 0 0 0 0 0 0 
30 31 32 32 32 30 0 0 0 0 0 0 0 0 0 0 0 0 0 0 0 0 0 0 0 0 0 0 0 0 0 0 0 0 0 0 0 0 0 
32 32 32 32 30 32 0 0 0 0 0 0 0 0 0 0 0 0 0 0 0 40 33 34 33 39 40 33 34 39 33 34 0 0 0 0 0 0 0 
30 32 32 31 32 32 0 0 0 0 0 0 0 0 0 0 0 0 0 0 0 0 35 0 35 0 0 35 0 0 35 0 0 0 0 0 0 0 0 
32 31 32 32 31 30 0 0 0 0 0 0 0 0 0 0 0 0 0 0 0 0 35 0 35 0 0 35 0 0 35 0 0 0 0 0 0 0 0 
32 32 32 32 32 32 32 32 32 32 32 31 32 32 32 32 32 32 32 32 0 0 35 0 35 0 0 35 0 0 35 0 0 0 0 0 0 0 0 
0 33 0 0 0 33 0 32 31 32 32 32 32 32 31 32 32 30 32 32 0 0 35 0 35 0 0 35 0 0 35 0 0 0 0 0 0 0 0 
0 35 0 0 0 35 0 32 32 30 32 32 30 30 32 31 32 32 32 32 0 0 35 0 35 0 0 35 0 0 35 0 0 0 0 0 0 0 0 
0 35 0 0 0 35 0 32 30 32 32 32 32 32 31 32 32 32 32 32 0 0 35 0 0 0 0 0 0 0 0 0 0 0 0 0 0 0 0 
0 35 0 0 0 35 0 32 32 32 30 32 31 32 32 32 32 30 32 32 0 0 35 0 0 0 0 0 0 0 0 0 0 0 0 0 0 0 0 
0 35 0 0 0 35 0 32 32 32 32 32 32 32 32 32 32 32 32 31 0 0 35 0 0 0 0 0 0 0 0 0 0 0 0 0 0 0 0 
0 35 0 0 0 35 0 32 32 32 32 32 32 32 32 32 32 32 32 32 0 0 35 0 0 0 0 0 0 0 0 0 0 0 0 0 0 0 0 
